20 36
 
1000 1000 1000 0 1000 1000 1000 1000 1000 0 3000 3000 0 1000 1000 1000 1000 1000 0 1000
1000 1000 1000 0 0 0 0 0 0 0 1000 1000 0 0 0 0 0 0 0 1000
1000 1000 1000 0 1000 1000 1000 1000 1000 1000 1000 1000 1000 1000 1000 1000 1000 1000 0 1000
1000 1000 1000 0 1000 1000 1000 1000 1000 1000 1000 1000 1000 1000 1000 1000 1000 1000 0 1000
1000 1000 1000 0 1000 1000 1000 1000 1000 0 1000 1000 1000 1000 1000 1000 1000 1000 0 1000
1000 1000 1000 0 4000 4000 4000 4000 4000 0 4000 4000 4000 4000 1000 1000 1000 1000 0 1000
1000 1000 1000 0 1000 1000 1000 1000 1000 0 2000 2000 2000 2000 2000 2000 2000 2000 0 1000
1000 1000 1000 0 1000 1000 1000 1000 1000 0 2000 2000 2000 2000 2000 2000 2000 2000 0 1000
1000 1000 1000 0 1000 1000 1000 1000 1000 0 2000 2000 2000 2000 2000 2000 2000 2000 0 1000
1000 1000 1000 0 4000 4000 4000 4000 4000 0 2000 2000 2000 2000 2000 2000 2000 2000 0 1000
1000 1000 1000 0 1000 1000 1000 1000 1000 1000 1000 1000 1000 1000 1000 1000 1000 1000 0 1000
1000 1000 1000 0 1000 1000 1000 1000 1000 1000 1000 1000 1000 1000 1000 1000 1000 1000 0 1000
1000 1000 1000 0 1000 1000 1000 1000 1000 1000 1000 1000 1000 1000 2000 2000 2000 2000 0 1000
1000 1000 1000 0 0 0 4000 4000 4000 4000 0 0 0 0 2000 2000 2000 2000 0 1000
1000 1000 1000 0 1000 1000 1000 1000 1000 1000 1000 1000 1000 1000 2000 2000 2000 2000 0 1000
1000 1000 1000 0 1000 1000 1000 1000 1000 1000 1000 1000 1000 1000 2000 2000 2000 2000 0 1000
1000 1000 1000 0 1000 1000 1000 1000 1000 1000 1000 1000 1000 1000 1000 1000 1000 1000 0 1000
1000 1000 1000 0 1000 1000 1000 1000 1000 1000 1000 1000 1000 1000 1000 1000 1000 1000 0 1000
1000 1000 1000 0 1000 1000 1000 1000 1000 1000 1000 1000 1000 1000 1000 1000 1000 1000 0 1000
1000 1000 1000 0 4000 1000 4000 4000 4000 1000 4000 4000 4000 4000 4000 4000 4000 4000 0 1000
1000 1000 1000 0 1000 1000 1000 1000 1000 1000 1000 1000 1000 1000 1000 1000 1000 1000 0 1000
1000 1000 1000 0 1000 1000 1000 1000 1000 1000 1000 1000 1000 1000 1000 1000 1000 1000 0 1000
1000 1000 1000 0 1000 1000 1000 1000 1000 1000 1000 1000 2000 2000 2000 2000 1000 1000 0 1000
1000 1000 1000 0 0 0 0 0 0 0 0 0 2000 2000 2000 2000 4000 4000 0 1000
1000 1000 1000 0 1000 1000 1000 1000 1000 1000 1000 1000 2000 2000 2000 2000 1000 1000 0 1000
1000 1000 1000 0 1000 1000 1000 1000 1000 1000 1000 1000 2000 2000 2000 2000 1000 1000 0 1000
1000 1000 1000 0 1000 1000 1000 1000 1000 1000 1000 1000 1000 1000 1000 1000 1000 1000 0 1000
1000 1000 1000 0 4000 4000 1000 1000 1000 0 4000 4000 4000 4000 4000 4000 4000 4000 0 1000
1000 1000 1000 0 1000 1000 2000 2000 2000 2000 1000 1000 1000 1000 2000 2000 2000 2000 0 1000
1000 1000 1000 0 1000 1000 2000 2000 2000 2000 1000 1000 1000 1000 2000 2000 2000 2000 0 1000
1000 1000 1000 0 2000 2000 2000 2000 1000 1000 1000 1000 2000 2000 2000 2000 1000 1000 0 1000
1000 1000 1000 0 2000 2000 2000 2000 1000 1000 1000 1000 2000 2000 2000 2000 1000 1000 0 1000
1000 1000 1000 0 0 0 0 0 0 0 2000 2000 0 0 0 0 0 0 0 1000
1000 1000 1000 0 1000 1000 1000 1000 1000 0 2000 2000 0 1000 1000 1000 1000 1000 0 1000
1000 1000 1000 0 1000 1000 1000 1000 1000 0 2000 2000 0 1000 1000 1000 1000 1000 0 1000
1000 1000 1000 0 1000 1000 1000 1000 1000 0 3000 3000 0 1000 1000 1000 1000 1000 0 1000
